11111111111111111111111111
1000C0000000000C00000C0001
101E0101001000001010010001
101001001010101000100100P1
100010000C00C0000000000001
11111111111111111111111111