11111111
10C00E11
100P0C11
11111111