1111111111
1000C100P1
1011011101
1001110001
10000E0111
1111111111
