1111111111
10000E0001
1010111101
10111P0101
1C01001101
1111100001
1111111111