111111111111
10ECP0000011
111111111111