1111111111
10EC00C001
1000111101
10001P0101
1000101101
1111100001
1111111111